wwwwwwwwwwwwwwwwwwwwwwww
wc.....................w
w......................w
w..............c.......w
w...........A..........w
w..................c...w
w..........c...........w
w......................w
w......................w
w..................g...w
wwwwwwwwwwwwwwwwwwwwwwww