wwwwwwwwwwwwwwwwwwwwwwww
wc.....................w
w..................A...w
w......................w
w......................w
w......................w
w......................w
w..................c...w
w..................g...w
w......................w
wwwwwwwwwwwwwwwwwwwwwwww