wwwwwwwwwwwwwwwwwwwwwwww
w.....www.............cw
w.....................cw
w.....................cw
w.....................cw
w.A...................cw
w.....................cw
w......g..............cw
w.....................cw
w.....................cw
wwwwwwwwwwwwwwwwwwwwwwww